0,1,2,3,4,5,6,7,8,9,10,11,12,13,14,15,16,17,18,19,20,21,22,23,24,248,248,310,311,312,313,314,315,316,317,318,319,320,321,322,323,324,325,326,327,328,329,330,331,332,333,334,335,336,337,338,339,340,341,342,343,344,345,346,496,497,498,499,500,501,502,503,504,505,506,507,508,509,510,511,512,513,514,515,516,517,518,519,520,521,522,523,524,525,526,527,528,529,530,531
62,63,64,65,66,67,68,69,70,71,72,73,74,75,76,77,78,79,80,81,82,83,84,85,86,310,310,372,373,374,375,376,377,378,379,380,381,382,383,384,385,386,387,388,389,390,391,392,393,394,395,396,397,398,399,400,401,402,403,404,405,406,407,408,558,559,560,561,562,563,564,565,566,567,568,569,570,571,572,573,574,575,576,577,578,579,580,581,582,583,584,585,586,587,588,589,590,591,592,593
124,125,126,127,128,129,130,131,132,133,134,135,136,137,138,139,140,141,142,143,144,145,146,147,148,372,372,434,435,436,437,438,439,440,441,442,443,444,445,446,447,448,449,450,451,452,453,454,455,456,457,458,459,460,461,462,463,464,465,466,467,468,469,470,620,621,622,623,624,625,626,627,628,629,630,631,632,633,634,635,636,637,638,639,640,641,642,643,644,645,646,647,648,649,650,651,652,653,654,655
186,187,188,189,190,191,192,193,194,195,196,197,198,199,200,201,202,203,204,205,206,207,208,209,210,434,434,496,497,498,499,500,501,502,503,504,505,506,507,508,509,510,511,512,513,514,515,516,517,518,519,520,521,522,523,524,525,526,527,528,529,530,531,532,682,683,684,685,686,687,688,689,690,691,692,693,694,695,696,697,698,699,700,701,702,703,704,705,706,707,708,709,710,711,712,713,714,715,716,717
248,249,250,251,252,253,254,255,256,257,258,259,260,261,262,263,264,265,266,267,268,269,270,271,272,496,496,558,559,560,561,562,563,564,565,566,567,568,569,570,571,572,573,574,575,576,577,578,579,580,581,582,583,584,585,586,587,588,589,590,591,592,593,594,744,745,746,747,748,749,750,751,752,753,754,755,756,757,758,759,760,761,762,763,764,765,766,767,768,769,770,771,772,773,774,775,776,777,778,779
310,311,312,313,314,315,316,317,318,319,320,321,322,323,324,325,326,327,328,329,330,331,332,333,334,558,558,620,621,622,623,624,625,626,627,628,629,630,631,632,633,634,635,636,637,638,639,640,641,642,643,644,645,646,647,648,649,650,651,652,653,654,655,656,590,591,592,593,594,595,596,597,814,815,816,817,818,819,820,821,822,823,824,825,826,827,828,829,830,831,832,833,834,835,836,837,838,839,840,841
372,373,374,375,376,377,378,379,380,381,382,383,384,385,386,387,388,389,390,391,392,393,394,395,396,620,620,682,683,684,685,686,687,688,689,690,691,692,693,694,695,696,697,698,699,700,701,702,703,704,705,706,707,708,709,710,711,712,713,714,715,716,717,718,652,653,654,655,656,657,658,659,876,877,878,879,880,881,882,883,884,885,886,887,888,889,890,891,892,893,894,895,896,897,898,899,900,901,902,903
434,435,436,437,438,439,440,441,442,443,444,445,446,447,448,449,450,451,452,453,454,455,456,457,458,682,682,744,745,746,747,748,749,750,751,752,753,754,755,756,757,758,759,760,761,762,763,764,765,766,767,768,769,770,771,772,773,774,775,776,777,778,779,780,714,715,716,717,718,719,720,721,938,939,940,941,942,943,944,945,946,947,948,949,950,951,952,953,954,955,956,957,958,959,960,961,962,963,964,965
496,497,498,499,500,501,502,503,504,505,506,507,508,509,510,511,512,513,514,515,516,517,518,519,520,744,744,806,807,808,809,810,811,812,813,814,815,816,817,818,819,820,821,822,823,824,825,826,827,828,829,830,831,832,833,834,835,836,837,838,839,840,841,842,776,777,778,779,780,781,782,783,1000,1001,1002,1003,1004,1005,1006,1007,1008,1009,1010,1011,1012,1013,1014,1015,1016,1017,1018,1019,1020,1021,1022,1023,1024,1025,1026,1027
558,559,560,561,562,563,564,565,566,567,568,569,570,0,1,2,3,4,5,6,7,8,9,10,11,12,13,14,15,16,17,18,19,20,21,22,23,24,25,26,27,28,29,30,31,32,33,34,35,36,37,38,39,520,521,522,523,524,525,520,521,522,523,524,838,839,840,841,842,843,844,845,1062,1063,1064,1065,1066,1067,1068,1069,1070,1071,1072,1073,1074,1075,1076,1077,1078,1079,1080,1081,1082,1083,1084,1085,1086,1087,1088,1089
620,621,622,623,624,625,626,627,628,629,630,631,632,62,63,64,65,66,67,68,69,70,71,72,73,74,75,76,77,78,79,80,81,82,83,84,85,86,87,88,89,90,91,92,93,94,95,96,97,98,99,100,101,582,520,521,522,523,524,582,583,584,585,586,900,901,902,903,904,905,906,907,1124,1125,1126,1127,1128,1129,1130,1131,1132,1133,1134,1135,1136,1137,1138,1139,1140,1141,1142,1143,1144,1145,1146,1147,1148,1149,1150,1151
682,683,684,685,686,687,688,689,690,691,692,693,694,124,125,126,127,128,129,130,131,132,133,134,135,136,137,138,139,140,141,142,143,144,145,146,147,148,149,150,151,152,153,154,155,156,157,158,159,160,161,162,163,164,582,583,584,590,591,592,593,594,595,596,590,591,592,593,594,595,596,597,1186,1187,1188,1189,1190,1191,1192,1193,1194,1195,1196,1197,1198,1199,1200,1201,1202,1203,1204,1205,1206,1207,1208,1209,1210,1211,1212,1213
744,745,746,747,748,749,750,751,752,753,754,755,756,186,187,188,189,190,191,192,193,194,195,196,197,198,199,200,201,202,203,204,205,206,207,208,209,210,211,212,213,214,215,216,217,218,219,220,221,222,223,224,225,226,227,228,229,652,653,654,655,656,657,658,652,653,654,655,656,657,658,659,1248,1249,1250,1251,1252,1253,1254,1255,1256,1257,1258,1259,1260,1261,1262,1263,1264,1265,1266,1267,1268,1269,1270,1271,1272,1273,1274,1275
806,807,808,809,810,811,812,813,814,815,816,817,818,248,249,250,251,252,253,254,255,256,257,258,259,260,261,262,263,264,265,266,267,268,269,270,271,272,273,274,275,276,277,278,279,280,281,282,283,284,285,286,287,288,289,290,291,714,715,716,590,591,592,593,714,715,716,717,718,719,720,721,1310,1311,1312,1313,1314,1315,1316,1317,1318,1319,1320,1321,1322,1323,1324,1325,1326,1327,1328,1329,1330,1331,1332,1333,1334,1335,1336,1337
868,869,870,871,872,873,874,875,876,877,878,879,880,310,311,312,313,314,315,316,317,318,319,320,321,322,323,324,325,326,327,328,329,330,331,332,333,334,335,336,337,338,339,340,341,342,343,344,345,346,347,348,349,350,590,591,592,593,594,595,652,653,654,655,776,777,778,779,780,781,782,783,1372,1373,1374,1375,1376,1377,1378,1379,1380,1381,1382,1383,1384,1385,1386,1387,1388,1389,1390,1391,1392,1393,1394,1395,1396,1397,1398,1399
930,931,932,933,934,935,936,937,938,939,940,941,942,372,373,374,375,376,377,378,379,380,381,382,383,384,385,386,387,388,389,390,391,392,393,394,395,396,397,398,399,400,401,402,403,404,405,406,407,408,409,410,411,412,590,590,591,592,593,594,595,596,597,717,838,839,840,841,842,843,844,845,1434,1435,1436,1437,1438,1439,1440,1441,1442,1443,1444,1445,1446,1447,1448,1449,1450,1451,1452,1453,1454,1455,1456,1457,1458,1459,1460,1461
992,993,994,995,996,997,998,999,1000,1001,1002,1003,1004,434,435,436,437,438,439,440,441,442,443,444,445,446,447,448,449,450,451,452,453,454,455,456,457,458,459,460,461,462,463,464,465,466,467,468,469,470,471,472,473,474,652,652,653,654,655,656,657,658,659,779,900,901,902,903,904,905,906,907,1496,1497,1498,1499,1500,1501,1502,1503,1504,1505,1506,1507,1508,1509,1510,1511,1512,1513,1514,1515,1516,1517,1518,1519,1520,1521,1522,1523
13,14,15,16,17,18,19,20,21,22,23,24,25,496,497,498,499,500,501,502,503,504,505,506,507,508,509,510,511,512,513,514,515,516,517,518,519,520,521,522,523,524,525,526,527,528,529,530,531,532,533,534,535,536,714,714,715,716,717,718,719,720,721,841,962,963,964,965,966,967,968,969,1558,1559,1560,1561,1562,1563,1564,1565,1566,1567,1568,1569,1570,1571,1572,1573,1574,1575,1576,1577,1578,1579,1580,1581,1582,1583,1584,1585
75,76,77,78,79,80,81,82,83,84,85,86,87,558,559,560,561,562,563,564,565,566,567,568,569,570,571,572,573,574,575,576,577,578,579,580,581,582,583,584,585,586,587,588,589,590,591,592,593,594,595,596,597,598,776,776,777,778,779,780,781,782,783,903,962,963,964,965,966,967,968,969,1620,1621,1622,1623,1624,1625,1626,1627,1628,1629,1630,1631,1632,1633,1634,1635,1636,1637,1638,1639,1640,1641,1642,1643,1644,1645,1646,1647
137,138,139,140,141,142,143,144,145,146,147,148,149,620,621,622,623,624,625,626,627,628,629,630,631,632,633,634,635,636,637,638,639,640,641,642,643,644,645,646,647,648,649,650,651,652,653,654,655,656,657,658,659,660,838,838,839,840,841,842,843,844,845,965,966,967,968,969,675,676,677,678,30,31,32,33,34,35,36,37,38,39,40,41,42,43,44,45,46,47,48,49,50,51,52,53,54,55,56,57
199,200,201,202,203,204,205,206,207,208,209,210,211,682,683,684,685,686,687,688,689,690,691,692,693,694,695,696,697,698,699,700,701,702,703,704,705,706,707,708,709,710,711,712,713,714,715,716,717,718,719,720,721,722,900,900,901,902,903,904,905,906,907,974,975,976,977,736,737,738,739,740,92,93,94,95,96,97,98,99,100,101,102,103,104,105,106,107,108,109,110,111,112,113,114,115,116,117,118,119
261,262,263,264,265,266,267,268,269,270,271,272,273,744,745,746,747,748,749,750,751,752,753,754,755,756,757,758,759,760,761,762,763,764,765,766,767,768,769,770,771,772,773,774,775,776,777,778,779,780,781,782,783,784,962,962,963,964,965,966,967,968,969,1036,1037,1038,1039,798,799,800,801,802,154,155,156,157,158,159,160,161,162,163,164,165,166,167,168,169,170,171,172,173,174,175,176,177,178,179,180,181
323,324,325,326,327,328,329,330,331,332,333,334,335,806,807,808,809,810,811,812,813,814,815,816,817,818,819,820,821,822,823,824,825,826,827,828,829,830,831,832,833,834,835,836,837,838,839,840,841,842,843,844,845,846,847,848,849,850,851,852,1095,1096,1097,1098,1099,1100,1101,860,861,862,863,864,216,217,218,219,220,221,222,223,224,225,226,227,228,229,230,231,232,233,234,235,236,237,238,239,240,241,242,243
385,386,387,388,389,390,391,392,393,394,395,396,397,868,869,870,871,872,873,874,875,876,877,878,879,880,881,882,883,884,885,886,887,888,889,890,891,892,893,894,895,896,897,898,899,900,901,902,903,904,905,906,907,908,909,910,911,971,972,973,1157,1158,1159,1160,1161,1162,1163,922,923,924,925,926,278,279,280,281,282,283,284,285,286,287,288,289,290,291,292,293,294,295,296,297,298,299,300,301,244,245,246,247
447,448,449,450,451,452,453,454,455,456,457,458,459,930,931,932,933,934,935,936,937,938,939,940,941,942,943,944,945,946,947,948,949,950,951,952,953,954,955,956,957,958,959,960,961,962,963,964,965,966,967,968,969,971,972,973,974,1033,1034,1035,1219,1220,1221,1222,1223,1224,1225,984,985,986,987,988,340,341,342,343,344,345,346,347,348,349,350,351,352,353,354,355,356,357,358,359,360,361,362,363,306,307,308,309
509,510,511,512,513,514,515,516,517,518,519,520,521,992,993,994,995,996,997,998,999,1000,1001,1002,1003,1004,1005,1006,1007,1008,1009,1010,1011,1012,1013,1014,1015,1016,1017,1018,1019,1020,1021,1022,1023,1024,1025,1026,1027,1028,1029,1030,1031,971,972,973,974,1095,1096,1097,1281,1282,1283,1284,1285,1286,1287,14,15,16,17,18,19,20,21,22,23,24,25,26,27,28,29,30,31,32,33,34,35,36,37,38,39,40,41,42,368,369,370,371
571,572,573,574,575,576,577,578,579,580,581,582,583,1054,1055,1056,1057,1058,1059,1060,1061,1062,1063,1064,1065,1066,1067,1068,1069,1070,1071,1072,1073,1074,1075,1076,1077,1078,1079,1080,1081,1082,1083,1084,1085,1086,1087,1088,1089,1090,1091,1092,971,1033,1034,1035,1036,1157,1158,1159,1160,1161,1162,1163,73,74,75,76,77,78,79,80,81,82,83,84,85,86,87,88,89,90,91,92,93,94,95,96,97,98,99,100,101,102,103,104,430,431,432,433
633,634,635,636,637,638,639,640,641,642,643,644,645,1116,1117,1118,1119,1120,1121,1122,1123,1124,1125,1126,1127,1128,1129,1130,1131,1132,1133,1134,1135,1136,1137,1138,1139,1140,1141,1142,1143,1144,1145,1146,1147,1148,1149,1150,1151,1152,1153,1154,1033,1095,1096,1097,1098,1219,1220,1221,1222,1223,1224,1225,135,136,137,138,139,140,141,1598,1599,1600,1601,1602,1603,148,149,150,151,152,153,154,155,156,157,158,159,160,161,427,428,429,430,431,492,493,494,495
695,696,697,698,699,700,701,702,703,704,705,706,707,1178,1179,1180,1181,1182,1183,1184,1185,1186,1187,1188,1189,1190,1191,1192,1193,1194,1195,1196,1197,1198,1199,1200,1201,1202,1203,1204,1205,1206,1207,1208,1209,1210,1211,1212,1213,1214,1215,1216,1095,1157,1158,1159,1648,1649,1650,1651,1652,1653,1654,1655,1656,1657,1598,1599,1600,1601,1602,1660,1661,1662,1663,1664,1665,210,211,212,213,214,215,216,217,218,219,220,221,222,223,489,490,491,492,493,554,555,556,557
757,758,759,760,761,762,763,764,765,766,767,768,769,1240,1241,1242,1243,1244,1245,1246,1247,1248,1249,1250,1251,1252,1253,1254,1255,1256,1257,1258,1259,1260,1261,1262,1263,1264,1265,1266,1267,1268,1269,1270,1271,1272,1273,1274,1275,1276,1277,1278,1157,1219,1220,1221,1710,1711,1712,1713,1714,1715,1716,1717,1718,1719,1660,1661,1662,1663,1664,1722,1723,1724,1725,1726,1727,272,273,274,275,276,277,278,279,280,281,282,283,284,285,551,552,553,554,555,616,617,618,619
819,820,821,822,823,824,825,826,827,828,829,830,831,1302,1303,1304,1305,1306,1307,1308,1309,1310,1311,1312,1313,1314,1315,1316,1317,1318,1319,1320,1321,1322,1323,1324,1325,1326,1327,1328,1329,1330,1331,971,972,973,974,975,976,977,1339,1340,1219,1281,1282,1283,1772,1773,1774,1775,1776,1777,1778,1779,1780,1781,1722,1723,1724,1725,1726,1784,1785,1786,1787,1788,1789,334,335,336,337,338,339,340,341,342,343,344,345,346,347,613,614,615,616,617,678,679,680,681
881,882,883,884,885,886,887,888,889,890,891,892,893,1364,1365,1366,1367,1368,1369,1370,1371,1372,1373,1374,1375,1376,1377,1378,772,773,774,775,776,777,778,779,779,1388,1389,1390,1391,1392,1393,1033,1034,1035,1036,1037,1038,1039,1401,1402,1281,1282,1283,1284,1834,1835,1836,1837,1838,1839,1840,1841,1842,1843,1784,1785,1786,1787,1788,1846,1847,1848,1849,1850,1851,396,397,398,399,400,401,402,403,404,405,406,407,408,409,675,676,677,678,679,740,741,742,743
943,944,945,946,947,948,949,950,951,952,953,954,955,1426,1427,1428,1429,1430,1431,1432,1433,1434,1435,1436,1437,1438,1439,1440,772,773,774,775,776,777,778,779,841,1450,1451,1452,1453,1454,1455,1095,1096,1097,1098,1099,1100,1101,1463,1464,1465,434,435,436,1896,1897,1898,1899,1900,1901,1902,1903,1904,1905,1846,1847,1848,1849,1850,1908,1909,1910,1911,1912,1913,458,459,460,461,462,463,464,465,466,467,468,469,470,471,737,738,739,740,741,802,803,804,805
1005,1006,1007,1008,1009,1010,1011,1012,1013,1014,1015,1016,1017,1488,1489,1490,1491,1492,1493,1494,1495,1496,1497,1498,1499,1500,772,773,774,775,776,777,778,779,778,779,903,777,778,779,1515,1516,1517,1157,1158,1159,1160,1161,1162,1163,1525,1526,1527,496,497,498,1958,1959,1960,1961,1962,1963,1964,1965,1966,1967,1908,1909,1910,1911,1912,1970,1971,1972,1973,1974,1975,520,521,522,523,524,525,526,527,528,529,530,531,532,533,799,800,801,802,803,864,865,866,867
1067,1068,1069,1070,1071,1072,1073,1074,1075,1076,1077,1078,1079,1550,1551,1552,1553,1554,1555,1556,1557,1558,1559,1560,1561,772,773,774,775,776,777,778,779,779,778,779,965,779,779,841,1577,1578,1579,1219,1220,1221,1222,1223,1224,1225,977,1588,1589,558,1648,1649,2020,2021,2022,2023,2024,2025,2026,2027,1598,1599,1970,1971,1972,1973,1974,2032,2033,2034,2035,2036,2037,582,583,584,585,586,587,588,589,590,591,592,593,594,595,861,862,863,864,865,926,927,928,929
1129,1130,1131,1132,1133,1134,1135,1136,1137,1138,1139,1140,1141,1612,1613,1614,1615,1616,1617,1618,1619,1620,1621,1622,1623,772,773,774,775,776,777,778,779,841,779,779,1027,841,841,903,1639,971,972,973,974,975,976,977,1286,1526,1527,1528,1529,1530,1710,1711,2082,2083,2084,2085,2086,2087,2088,2089,1660,1661,2032,2033,2034,2035,2036,2094,2095,2096,2097,2098,2099,644,645,646,647,648,649,650,651,652,653,654,655,656,657,923,924,925,926,927,988,989,990,991
1191,1192,1193,1194,1195,1196,1197,0,1,2,3,4,5,6,7,8,9,10,11,12,13,14,15,16,772,772,773,774,775,776,777,778,779,903,841,841,1089,903,903,965,33,1033,1034,1035,1036,1037,1038,1039,1099,1588,1589,1590,1591,1592,1772,1773,2144,2145,2146,2147,2148,2149,2150,2151,1722,1723,2094,2095,1598,1599,1600,2156,2157,2158,2159,2160,2161,706,707,708,709,710,711,712,713,714,715,716,717,718,719,985,986,987,988,989,1050,1051,1052,1053
1253,1254,1255,1256,1257,1258,1259,62,63,64,65,66,67,68,69,70,71,72,73,74,75,76,77,78,834,834,772,772,772,772,773,774,775,776,777,778,779,778,779,1027,95,1095,1096,1097,1098,1099,1100,1101,1161,1650,1651,1652,1653,1654,1834,1835,1836,1837,1838,1839,1840,1841,1842,1843,1598,1599,1600,1601,1602,1603,1662,1663,1664,1665,1665,766,767,768,769,770,771,772,773,774,775,776,777,778,779,780,781,1047,1048,1049,1050,1051,1112,1113,1114,1115
1315,1316,1317,1318,1319,1320,1321,124,125,126,127,128,129,130,131,132,133,134,135,136,137,138,139,140,896,896,772,834,834,772,773,774,775,776,777,778,779,776,777,778,779,1157,1158,1159,1160,1161,1162,1163,1223,1712,1713,1714,1715,1716,1896,1897,1898,1899,1900,1901,1902,1903,1904,1598,1660,1661,1662,1663,1664,1665,1724,1725,1726,1727,1727,828,829,830,831,832,833,834,835,836,837,838,839,840,841,842,843,1109,1110,1111,1112,1113,1174,1175,1176,1177
1377,1378,1379,1380,1381,1382,1383,186,187,188,189,190,191,192,193,194,195,196,197,198,199,200,201,202,958,958,834,896,896,834,772,773,774,775,776,777,778,779,774,775,776,777,778,779,1222,1223,1224,1225,1285,1774,1775,1776,1777,1778,1958,1959,1960,1961,1962,1963,1964,1965,1966,1660,1722,1723,1724,1725,1726,1727,1786,1787,1788,1789,1789,890,891,892,893,894,895,896,897,898,899,900,901,902,903,904,905,1171,1172,1173,1174,1175,1236,1237,1238,1239
1439,1440,1441,1442,1443,1444,1445,248,249,250,251,252,253,254,255,256,257,258,259,260,261,262,263,772,772,772,896,958,958,896,772,773,774,775,776,777,778,779,778,779,779,779,779,779,1526,1527,1528,1529,1530,1531,1532,1533,1839,1840,2020,2021,2022,2023,2024,2025,2026,2027,2028,1722,1784,1785,1786,1787,1788,1789,1848,1849,1850,1851,1851,952,953,954,955,956,957,958,959,960,961,962,963,964,965,966,967,1233,1234,1235,1236,1237,1298,1299,1300,1301
1501,1502,1503,1504,1505,1506,1507,310,311,312,313,314,315,316,317,318,319,320,321,322,323,324,325,834,834,834,958,1020,1020,958,772,773,774,775,776,777,778,779,779,779,841,841,841,841,1526,1526,1527,1528,1529,1530,1531,1648,1649,1650,2082,2083,2084,2085,2086,2087,2088,2089,2090,1784,1846,1847,1848,1849,1850,1851,1910,1911,1912,1913,1913,1014,1015,1016,1017,1018,1019,1020,1021,1022,1023,1024,1025,1026,1027,1028,1029,1295,1296,1297,1298,1299,1360,1361,1362,1363
1563,1564,1565,1566,1567,1568,1569,372,373,374,375,376,377,378,379,380,381,382,383,384,385,386,387,896,896,896,1020,1082,1082,1020,834,835,836,837,838,839,840,841,841,841,903,903,903,903,1526,1526,1527,1528,1529,1530,1531,1710,1711,1712,2144,2145,2146,2147,2148,2149,2150,2151,2152,1846,1908,1909,1910,1911,1912,1913,1972,1973,1974,1975,1975,1076,1077,1078,1079,1080,1081,1082,1083,1084,1085,1086,1087,1088,1089,1090,1091,1357,1358,1359,1360,1361,1422,1423,1424,1425
1625,1626,1627,1628,1629,1630,1631,434,435,436,437,438,439,440,441,442,443,444,445,446,447,448,449,958,958,958,1082,1082,1083,1082,896,897,898,899,900,901,902,903,903,903,965,965,965,965,1588,1588,1589,1590,1591,1592,1593,1772,1773,1774,1775,1776,1777,1778,1779,1780,1781,1782,1125,1908,1970,1971,1972,1973,1974,1975,2034,2035,2036,2037,2037,1138,1139,1140,1141,1142,1143,1144,1145,1146,1147,1148,1149,1150,1151,1152,1153,1419,1420,1421,1422,1423,1484,1485,1486,1487
1687,1688,1689,1690,1691,1692,1693,496,497,498,499,500,501,502,503,504,505,506,507,508,509,510,511,1020,1020,1020,1082,1083,1084,1085,958,959,960,961,962,963,964,965,965,965,1027,1027,1027,1027,1650,1526,1527,1528,1529,1530,1531,1834,1835,1836,1837,1838,1839,1840,1841,1842,1843,1844,1187,1970,2032,2033,2034,2035,2036,2037,2096,2097,2098,2099,2099,1200,1201,1202,1203,1204,1205,1206,1207,1208,1209,1210,1211,1212,1213,1214,1215,1481,1482,1483,1484,1485,1546,1547,1548,1549
1749,1750,1751,1752,1753,1754,1755,558,559,560,561,562,563,564,565,566,567,568,569,570,571,572,573,1082,1082,1082,1082,1083,1084,1085,1020,1021,1022,1023,1024,1025,1026,1027,1027,1027,1089,1089,1089,1089,1712,1526,1527,1528,1529,1530,1531,1896,1897,1898,1899,1900,1901,1902,1903,1904,1905,1906,1527,2032,2094,2095,2096,2097,2098,2099,2158,2159,2160,2161,2161,1262,1263,1264,1265,1266,1267,1268,1269,1270,1271,1272,1273,1274,1275,1276,1277,1543,1544,1545,1546,1547,1608,1609,1610,1611
1811,1812,1813,1814,1815,1816,1817,620,621,622,623,624,625,626,627,628,629,630,631,632,633,634,635,1082,1083,1084,1082,1083,1084,1085,1082,1083,1084,1085,1086,1087,1088,1089,1089,1089,653,654,655,656,1774,1526,1527,1528,1529,1530,1526,1958,1959,1960,1961,1962,1963,1964,1965,1966,1967,1968,1528,2094,2156,2157,2158,2159,2160,2161,1319,1320,1321,1322,1323,1324,1325,1326,1327,1328,1329,1330,1331,1332,1333,1334,1335,1336,1337,1338,1339,1605,1606,1607,1608,1609,1670,1671,1672,1673
1873,1874,1875,1876,1877,1878,1879,682,683,684,685,686,687,688,689,690,691,692,693,694,695,696,697,698,699,700,1082,1083,1084,1085,1086,1087,1088,1089,1089,710,711,712,713,714,715,716,717,1526,1526,1526,1526,1526,1526,1526,1588,2020,2021,2022,2023,2024,2025,2026,2027,2028,2029,2030,1531,2156,2156,2157,2158,2159,2160,2161,1381,1382,1383,1384,1385,1386,1387,1388,1389,1390,1391,1392,1393,1394,1395,1396,1397,1398,1399,1400,1401,1667,1668,1669,1670,1671,1732,1733,1734,1735
1935,1936,1937,1938,1939,1940,1941,744,745,746,747,748,749,750,751,752,753,754,755,756,757,758,759,760,761,762,763,764,765,766,767,768,769,770,771,772,773,774,775,776,777,1526,1526,1588,1588,1588,1588,1588,1526,1526,1526,2082,2083,2084,2085,2086,2087,2088,2089,2090,2091,2092,1532,2156,2157,2158,2159,2160,2161,1442,1443,1444,1445,1446,1447,1448,1449,1450,1451,1452,1453,1454,1455,1456,1457,1458,1459,1460,1461,1462,1463,1729,1730,1731,1732,1733,1794,1795,1796,1797
1997,1998,1999,2000,2001,2002,2003,806,807,808,809,810,811,812,813,814,815,816,817,818,819,820,821,822,823,824,825,826,827,828,829,830,831,832,833,834,835,836,837,838,1526,1588,1588,1650,1650,1650,1650,1526,1588,1588,1588,2144,2145,2146,2147,2148,2149,2150,2151,2152,2153,2154,1533,1595,1595,1657,1657,1719,1719,1504,1505,1506,1507,1508,1509,1510,1511,1512,1513,1514,1515,1516,1517,1518,1519,1520,1521,1522,1523,1524,1525,1791,1792,1793,1794,1795,1856,1857,1858,1859
2059,2060,2061,2062,2063,2064,2065,868,869,870,871,872,873,874,875,876,877,878,879,880,881,882,883,884,885,886,887,888,889,890,891,892,893,894,895,896,897,898,899,900,1588,1650,1650,1712,1712,1712,1712,1588,1650,1650,1650,1712,1712,1712,1588,1589,1590,1591,1592,1593,1594,1595,1595,1657,1657,1719,1719,1781,1781,1566,1567,1568,1569,1570,1571,1572,1573,1574,1575,1576,1577,1578,1579,1580,1581,1582,1583,1584,1585,1586,1587,1853,1854,1855,1856,1857,1918,1919,1920,1921
2121,2122,2123,2124,2125,2126,2127,930,931,932,933,934,935,936,937,938,939,940,941,942,943,944,945,946,947,948,949,950,951,952,953,954,955,956,957,958,959,960,961,962,1650,1712,1712,1774,1774,1774,1774,1650,1712,1712,1712,1774,1774,1774,1650,1651,1652,1653,1654,1655,1656,1657,1657,1719,1719,1781,1781,1843,1843,1628,1629,1630,1631,1632,1633,1634,1635,1636,1637,1638,1639,1640,1641,1642,1643,1644,1645,1646,1647,1648,1649,1915,1916,1917,1918,1919,1980,1981,1982,1983
1054,1055,1056,1057,1058,1059,1060,992,993,994,995,996,997,998,999,1000,1001,1002,1003,1004,1005,1006,1007,1008,1009,1010,1011,1012,1013,1014,1015,1016,1017,1018,1019,1020,1021,1022,1023,1024,1712,1774,1774,1836,1836,1836,1836,1712,1774,1774,1774,1836,1836,1836,1712,1713,1714,1715,1716,1717,1718,1719,1719,1781,1781,1843,1843,1688,1689,1690,1691,1692,1693,1694,1695,1696,1697,1698,1699,1700,1701,1702,1703,1704,1705,1706,1707,1708,1709,1710,1711,1977,1978,1979,1980,1981,2042,2043,2044,2045
1116,1117,1118,1119,1120,1121,1122,1054,1055,1056,1057,1058,1059,1060,1061,1062,1063,1064,1065,1066,1067,1068,1069,1070,1071,1072,1073,1074,1075,1076,1077,1078,1079,1080,1081,1082,1083,1084,1085,1086,1774,1836,1836,1837,1838,1839,1840,1774,1836,1836,1836,1837,1838,1839,1774,1775,1776,1777,1778,1779,1780,1781,1781,1843,1843,1748,1749,1750,1751,1752,1753,1754,1755,1756,1757,1758,1759,1760,1761,1762,1763,1764,1765,1766,1767,1768,1769,1770,1771,1772,1773,2039,2040,2041,2042,2043,2104,2105,2106,2107
1178,1179,1180,1181,1182,1183,1184,1116,1117,1118,1119,1120,1121,1122,1123,1124,1125,1126,1127,1128,1129,1130,1131,1132,1133,1134,1135,1136,1137,1138,1139,1140,1141,1142,1143,1144,1145,1146,1147,1148,1836,1837,1838,1839,1840,1841,1842,1836,1837,1838,1839,1840,1841,1842,1836,1837,1838,1839,1840,1841,1842,1843,1843,1808,1809,1810,1811,1812,1813,1814,1815,1816,1817,1818,1819,1820,1821,1822,1823,1824,1825,1826,1827,1828,1829,1830,1831,1832,1833,1834,1835,2101,2102,2103,2104,2105,2166,2167,2168,2169
