2861,3019,3256,3414,3572,3573,3574,3575,3576,3577,3578,3579,3580,3581,3582,3583,3584,3585,3493,3335,3256,3098,2940,2861,2703,2624,2625,2626,2627,2628,2629,2630,2631,2632,2633,2634,2635,2636,2637,2638,2639,2640,2641,2642,2643,2644,2645,2646,2647,2648,2647,2648,1930,1931,1932,1933,1934,1935,1936,1937,1938,1939,1940,1941,1942,1943,1944,2624,2782,2940,3177,3335,3414,3415,3416,3417,3418,3419,3420,3421,3422,3423,3424,3425,3426,3427,3428,3429,3430,3431,3432,3433,3434,3435,3436,3437,3438,3292,3292,3371
2940,3098,3335,3493,3572,3573,3574,3575,3576,3577,3578,3579,3580,3581,3582,3583,3584,3585,3572,3414,3335,3177,3019,2940,2782,2624,2625,2626,2627,2628,2629,2630,2631,2632,2633,2634,2635,2636,2637,2638,2639,2640,2641,2642,2643,2644,2645,2646,2647,2648,2647,2648,2009,2010,2011,2012,2013,2014,2015,2016,2017,2018,2019,2020,2021,2022,2023,2703,2861,3019,3256,3414,3493,3494,3495,3496,3497,3498,3499,3500,3501,3502,3503,3504,3505,3506,3507,3508,3509,3510,3511,3512,3513,3514,3515,3516,3517,3371,3371,3450
3019,3177,3414,3572,3573,3574,3575,3576,3577,3578,3579,3580,3581,3582,3583,3584,3585,3586,3587,3493,3414,3256,3098,3019,2861,2703,2624,2625,2626,2627,2628,2629,2630,2631,2632,2633,2634,2635,2636,2637,2638,2639,2640,2641,2642,2643,2644,2645,2646,2647,2648,2727,2088,2089,2090,2091,2092,2093,2094,2095,2096,2097,2098,2099,2100,2101,2102,2782,2940,3098,3335,3493,3572,3573,3574,3575,3576,3577,3578,3579,3580,3581,3582,3583,3584,3585,3586,3587,3588,3589,3590,3591,3592,3593,3594,3595,3596,3450,3450,3529
3098,3256,3493,3572,3573,3574,3575,3576,3577,3578,3579,3580,3581,3582,3583,3584,3585,3586,3587,3572,3493,3335,3177,3098,2940,2782,2703,2624,2625,2626,2627,2628,2629,2630,2631,2632,2633,2634,2635,2636,2637,2638,2639,2640,2641,2642,2643,2644,2645,2646,2647,2648,2167,2168,2169,2170,2171,2172,2173,2174,2175,2176,2177,2178,2179,2180,2624,2861,3019,3177,3414,3572,3572,3573,3574,3575,3576,3577,3578,3579,3580,3581,3582,3583,3584,3585,3586,3587,3588,3589,3590,3591,3592,3593,3594,3595,3596,3529,3529,3608
3177,3335,3572,3573,3574,3575,3576,3577,3578,3579,3580,3581,3582,3583,3584,3585,3586,3587,3588,3589,3572,3414,3256,3177,3019,2861,2782,2624,2625,2626,2627,2628,2629,2630,2631,2632,2633,2634,2635,2636,2637,2638,2639,2640,2641,2642,2643,2644,2645,2646,2647,2648,2246,2247,2248,2249,2250,2251,2252,2253,2254,2255,2256,2257,2258,2259,2703,2940,3098,3256,3493,3572,3573,3574,3575,3576,3577,3578,3579,3580,3581,3582,3583,3584,3585,3586,3587,3588,3589,3590,3591,3592,3593,3594,3595,3596,3529,3608,3608,3687
3256,3414,3572,3573,3574,3575,3576,3577,3578,3579,3580,3581,3582,3583,3584,3585,3586,3587,3588,3589,3590,3493,3335,3256,3098,2940,2861,2703,2624,2625,2626,2627,2628,2629,2630,2631,2632,2633,2634,2635,2636,2637,2638,2639,2640,2641,2642,2643,2644,2645,2646,2647,2648,2326,2327,2328,2329,2330,2331,2332,2333,2334,2335,2336,2337,2624,2782,3019,3177,3335,3572,3573,3574,3575,3576,3577,3578,3579,3580,3581,3582,3583,3584,3585,3586,3587,3588,3589,3590,3591,3592,3593,3594,3595,3596,3608,3608,3687,3687,3766
3335,3493,3572,3573,3574,3575,3576,3577,3578,3579,3580,3581,3582,3583,3584,3585,3586,3587,3588,3589,3590,3572,3414,3335,3177,3019,2940,2782,2624,2625,2626,2627,2628,2629,2630,2631,2632,2633,2634,2635,2636,2637,2638,2639,2640,2641,2642,2643,2644,2645,2646,2647,2648,2405,2406,2407,2408,2409,2410,2411,2412,2413,2414,2415,2416,2703,2861,3098,3256,3414,3572,3573,3574,3575,3576,3577,3578,3579,3580,3581,3582,3583,3584,3585,3586,3587,3588,3589,3590,3591,3592,3593,3594,3595,3596,3687,3687,3766,3766,3845
3414,3572,3573,3574,3575,3576,3577,3578,3579,3580,3581,3582,3583,3584,3585,3586,3587,3588,3589,3590,3591,3592,3493,3414,3256,3098,3019,2861,2703,2624,2625,2626,2627,2628,2629,2630,2631,2632,2633,2634,2635,2636,2637,2638,2639,2640,2641,2642,2643,2644,2645,2646,2647,2648,2485,2486,2487,2488,2489,2490,2491,2492,2493,2494,2624,2782,2940,3177,3335,3493,3572,3573,3574,3575,2706,3577,3578,3579,3580,3581,3582,3583,3584,3585,3586,3587,3588,3589,3590,3591,3592,3593,3594,3595,3596,3766,3766,3845,3845,3924
3493,3572,3573,3574,3575,3576,3577,3578,3579,3580,3581,3582,3583,3584,3585,3586,3587,3588,3589,3590,3591,3592,3572,3493,3335,3177,3098,2940,2782,2624,2625,2626,2627,2628,2629,2630,2631,2632,2633,2634,2635,2636,2637,2638,2639,2640,2641,2642,2643,2644,2645,2646,2647,2648,2564,2565,2566,2567,2568,2569,2570,2571,2572,2573,2703,2861,3019,3256,3414,3572,3573,3574,3575,2784,3577,3578,3579,3580,3581,3582,3583,3584,3585,3586,3587,3588,3589,3590,3591,3592,3593,3594,3595,3596,3766,3845,3845,3924,3924,4003
3572,3573,3574,3575,3576,3577,3578,3579,3580,3581,3582,3583,3584,3585,3586,3587,3588,3589,3590,3591,3592,3593,3594,3572,3414,3256,3177,3019,2861,2703,2624,2625,2626,2627,2628,2629,2630,2631,2632,2633,2634,2635,2636,2637,2638,2639,2640,2641,2642,2643,2644,2645,2646,2647,2648,2644,2645,2646,2647,2648,2649,2650,2651,2624,2782,2940,3098,3335,3493,3572,3573,3574,3575,2863,3577,3578,3579,3580,3581,3582,3583,3584,3585,3586,3587,3588,3589,3590,3591,3592,3593,3594,3595,3596,3845,3924,3924,4003,4003,4082
3572,3573,3574,3575,3576,3577,3578,3579,3580,3581,3582,3583,3584,3585,3586,3587,3588,3589,3590,3591,3592,3593,3594,3595,3493,3335,3256,3098,2940,2782,2624,2625,2626,2627,2628,2629,2630,2631,2632,2633,2634,2635,2636,2637,2638,2639,2640,2641,2642,2643,2644,2645,2646,2647,2648,2723,2724,2725,2726,2727,2728,2729,2730,2703,2861,3019,3177,3414,3572,3573,3574,3575,2941,3577,3578,3579,3580,3581,3582,3583,3584,3585,3586,3587,3588,3589,3590,3591,3592,3593,3594,3595,3596,3845,3924,4003,4003,4082,4082,4161
3572,3573,3574,3575,3576,3577,3578,3579,3580,3581,3582,3583,3584,3585,3586,3587,3588,3589,3590,3591,3592,3593,3594,3595,3572,3414,3335,3177,3019,2861,2703,2624,2625,2626,2627,2628,2629,2630,2631,2632,2633,2634,2635,2636,2637,2638,2639,2640,2641,2642,2643,2644,2645,2646,2647,2648,2803,2804,2805,2806,2807,2808,2809,2782,2940,3098,3256,3493,3572,3573,3574,3575,3020,3577,3578,3579,3580,3581,3582,3583,3584,3585,3586,3587,3588,3589,3590,3591,3592,3593,3594,3595,3596,3924,4003,4082,4082,4161,4161,4240
3572,3573,3574,3575,3576,3577,3578,3579,3580,3581,3582,3583,3584,3585,3586,3587,3588,3589,3590,3591,3592,3593,3594,3595,3596,3493,3414,3256,3098,2940,2782,2624,2625,2626,2627,2628,2629,2630,2631,2632,2633,2634,2635,2636,2637,2638,2639,2640,2641,2642,2643,2644,2645,2646,2647,2648,2882,2883,2884,2885,2886,2887,2624,2861,3019,3177,3335,3572,3573,3574,3575,2941,3577,3578,3579,3580,3581,3582,3583,3584,3585,3586,3587,3588,3589,3590,2709,3592,3593,3594,3595,3596,3924,4003,4082,4161,4161,4240,4240,4319
3572,3573,3574,3575,3576,3577,3578,3579,3580,3581,3582,3583,3584,3585,3586,3587,3588,3589,3590,3591,3592,3593,3594,3595,3596,3572,3493,3335,3177,3019,2861,2703,2624,2625,2626,2627,2628,2629,2630,2631,2632,2633,2634,2635,2636,2637,2638,2639,2640,2641,2642,2643,2644,2645,2646,2647,2648,2962,2963,2964,2965,2966,2703,2940,3098,3256,3414,3572,3573,3574,3575,3020,3577,3578,3579,3580,3581,3582,3583,3584,3585,3586,3587,3588,3589,3590,3591,3592,3593,3594,3595,3596,4003,4082,4161,4240,4240,4319,4319,211
3573,3574,3575,3576,3577,3578,3579,3580,3581,3582,3583,3584,3585,3586,3587,3588,3589,3590,3591,3592,3593,3594,3595,3596,2629,2630,3572,3414,3256,3098,2940,2782,2703,2624,2625,2626,2627,2628,2629,2630,2631,2632,2633,2634,2635,2636,2637,2638,2639,2640,2641,2642,2643,2644,2645,2646,2647,2648,3042,3043,3044,3045,2782,3019,3177,3335,3493,3572,3573,3574,3575,3099,3577,3578,3579,3580,3581,3582,3583,3584,3585,3586,3587,3588,3589,3590,3591,3592,3593,3594,3595,3596,4082,4161,4240,4319,4319,211,211,290
3573,3574,3575,3576,3577,3578,3579,3580,3581,3582,3583,3584,3585,3586,3587,3588,3589,3590,3591,3592,3593,3594,3595,3596,2630,2631,2632,3493,3335,3177,3019,2861,2782,2624,2625,2626,2627,2628,2629,2630,2631,2632,2633,2634,2635,2636,2637,2638,2639,2640,2641,2642,2643,2644,2645,2646,2647,2648,3121,3122,3123,2624,2861,3098,3256,3414,3572,3573,3574,3575,3020,3577,3578,3579,3580,3581,3582,3583,3584,3585,3586,3587,3588,3589,3590,3591,3592,3593,3594,3595,3596,4082,4161,4240,4319,290,290,290,290,369
3573,3574,3575,3576,3577,3578,3579,3580,3581,3582,3583,3584,3585,3586,3587,3588,3589,3590,3591,3592,3593,3594,3595,3596,2631,2632,2633,3572,3414,3256,3098,2940,2861,2703,2624,2625,2626,2627,2628,2629,2630,2631,2632,2633,2634,2635,2636,2637,2638,2639,2640,2641,2642,2643,2644,2645,2646,2647,2648,3201,3202,2703,2940,3177,3335,3493,3572,3573,3574,3575,3099,3577,3578,3579,3580,3581,3582,3583,3584,3585,3586,3587,3588,3589,3590,3591,3592,3593,3594,3595,3596,2624,2625,2626,2627,2628,2629,2630,2631,2632
3573,3574,3575,3576,3577,3578,3579,3580,3581,3582,3583,3584,3585,3586,3587,3588,3589,3590,3591,3592,3593,3594,3595,3596,2632,2633,2634,2635,3493,3335,3177,3019,2940,2782,2624,2625,2626,2627,2628,2629,2630,2631,2632,2633,2634,2635,2636,2637,2638,2639,2640,2641,2642,2643,2644,2645,2646,2647,2648,3280,3281,2782,3019,3256,3414,3572,3573,3574,3575,2941,3577,3578,3579,3580,3581,3582,3583,3584,3585,3586,3587,3588,3589,3590,3591,3592,3593,3594,3595,3596,2624,2625,2626,2627,2628,2629,2630,2631,2632,2633
3574,3575,3576,3577,3578,3579,3580,3581,3582,3583,3584,3585,3586,3587,3588,3589,3590,3591,3592,3593,3594,3595,3596,2631,2632,2633,2634,2635,3572,3414,3256,3098,3019,2861,2703,2624,2625,2626,2627,2628,2629,2630,2631,2632,2633,2634,2635,2636,2637,2638,2639,2640,2641,2642,2643,2644,2645,2646,2647,2648,2624,2861,3098,3335,3493,3572,3573,3574,3575,3020,3577,3578,3579,3580,3581,3582,3583,3584,3585,3586,3587,3588,3589,3590,3591,3592,3593,3594,3595,3596,2627,2628,2629,2630,2631,2632,2633,2634,2635,2636
3574,3575,3576,3577,3578,3579,3580,3581,3582,3583,3584,3585,3586,3587,3588,3589,3590,3591,3592,3593,3594,3595,3596,2632,2633,2634,2635,2636,2637,3493,3335,3177,3098,2940,2782,2624,2625,2626,2627,2628,2629,2630,2631,2632,2633,2634,2635,2636,2637,2638,2639,2640,2641,2642,2643,2644,2645,2646,2647,2648,2703,2940,3177,3414,3572,3573,3574,3575,3020,3577,3578,3579,3580,3581,3582,3583,3584,3585,3586,3587,3588,3589,3590,3591,3592,3593,3594,3595,3596,2628,2629,2630,2631,2632,2633,2634,2635,2636,2637,2638
3574,3575,3576,3577,3578,3579,3580,3581,3582,3583,3584,3585,3586,3587,3588,3589,3590,3591,3592,3593,3594,3595,3596,2633,2634,2635,2636,2637,2638,3572,3414,3256,3177,3019,2861,2703,2624,2625,2626,2627,2628,2629,2630,2631,2632,2633,2634,2635,2636,2637,2638,2639,2640,2641,2642,2643,2644,2645,2646,2624,2782,3019,3256,3493,3572,3573,3574,3575,3099,3577,3578,3579,3580,3581,3582,3583,3584,3585,3586,3587,3588,3589,3590,3591,3592,3593,3594,3595,3596,2630,2631,2632,2633,2634,2635,2636,2637,2638,2639,2640
3575,3576,3577,3578,3579,3580,3581,3582,3583,3584,3585,3586,3587,3588,3589,3590,3591,3592,3593,3594,3595,3596,2634,2635,2636,2637,2638,2639,2640,2641,3493,3335,3256,3098,2940,2782,2703,2624,2625,2626,2627,2628,2629,2630,2631,2632,2633,2634,2635,2636,2637,2638,2639,2640,2641,2642,2643,2644,2645,2703,2861,3098,3335,3572,3573,3574,3575,2941,3577,3578,3579,3580,3581,3582,3583,3584,3585,3586,3587,3588,3589,3590,3591,3592,3593,3594,3595,3596,2631,2632,2633,2634,2635,2636,2637,2638,2639,2640,2641,2642
3575,3576,3577,3578,3579,3580,3581,3582,3583,3584,3585,3586,3587,3588,3589,3590,3591,3592,3593,3594,3595,3596,2635,2636,2637,2638,2639,2640,2641,2642,3572,3414,3335,3177,3019,2861,2782,2624,2625,2626,2627,2628,2629,2630,2631,2632,2633,2634,2635,2636,2637,2638,2639,2640,2641,2642,2643,2644,2645,2782,2940,3177,3414,3572,3573,3574,3575,3020,3577,3578,3579,3580,3581,3582,3583,3584,3585,3586,3587,3588,3589,3590,3591,3592,3593,3594,3595,3596,2633,2634,2635,2636,2637,2638,2639,2640,2641,2642,2643,2644
3575,3576,3577,3578,3579,3580,3581,3582,3583,3584,3585,3586,3587,3588,3589,3590,3591,3592,3593,3594,3595,3596,2636,2637,2638,2639,2640,2641,2642,2643,2644,3493,3414,3256,3098,2940,2861,2703,2624,2625,2626,2627,2628,2629,2630,2631,2632,2633,2634,2635,2636,2637,2638,2639,2640,2641,2642,2643,2624,2861,3019,3256,3493,3572,3573,3574,3575,3099,3577,3578,3579,3580,3581,3582,3583,3584,3585,3586,3587,3588,3589,3590,3591,3592,3593,3594,3595,3596,2635,2636,2637,2638,2639,2640,2641,2642,2643,2644,2645,2646
3575,3576,3577,3578,3579,3580,3581,3582,3583,3584,3585,3586,3587,3588,3589,3590,3591,3592,3593,3594,3595,3596,2637,2638,2639,2640,2641,2642,2643,2644,2645,3572,3493,3335,3177,3019,2940,2782,2624,2625,2626,2627,2628,2629,2630,2631,2632,2633,2634,2635,2636,2637,2638,2639,2640,2641,2642,2643,2703,2940,3098,3335,3572,3573,3574,3575,3099,3577,3578,3579,3580,3581,3582,3583,3584,3585,3586,3587,3588,3589,3590,3591,3592,3593,3594,3595,3596,2636,2637,2638,2639,2640,2641,2642,2643,2644,2645,2646,2647,2648
3575,3576,3577,3578,3579,3580,3581,3582,3583,3584,3585,3586,3587,3588,3589,3590,3591,3592,3593,3594,3595,3596,2638,2639,2640,2641,2642,2643,2644,2645,2646,2647,3572,3414,3256,3098,3019,2861,2703,2624,2625,2626,2627,2628,2629,2630,2631,2632,2633,2634,2635,2636,2637,2638,2639,2640,2641,2624,2782,3019,3177,3414,3572,3573,3574,3575,3178,3577,3578,3579,3580,3581,3582,3583,3584,3585,3586,3587,3588,3589,3590,3591,3592,3593,3594,3595,3596,2639,2640,2641,2642,2643,2644,2645,2646,2647,2648,2648,2648,2727
3576,3577,3578,3579,3580,3581,3582,3583,3584,3585,3586,3587,3588,3589,3590,3591,3592,3593,3594,3595,3596,2638,2639,2640,2641,2642,2643,2644,2645,2646,2647,2648,2727,3493,3335,3177,3098,2940,2782,2624,2625,2626,2627,2628,2629,2630,2631,2632,2633,2634,2635,2636,2637,2638,2639,2640,2641,2703,2861,3098,3256,3493,3572,3573,3574,3575,3257,3577,3578,3579,3580,3581,3582,3583,3584,3585,3586,3587,3588,3589,3590,3591,3592,3593,3594,3595,3596,2641,2642,2643,2644,2645,2646,2647,2648,2648,2727,2727,2727,2806
3576,3577,3578,3579,3580,3581,3582,3583,3584,3585,3586,3587,3588,3589,3590,3591,3592,3593,3594,3595,3596,2639,2640,2641,2642,2643,2644,2645,2646,2647,2648,2727,2806,3572,3414,3256,3177,3019,2861,2703,2624,2625,2626,2627,2628,2629,2630,2631,2632,2633,2634,2635,2636,2637,2638,2639,2624,2782,2940,3177,3335,3572,3573,3574,3575,3178,3577,3578,3579,3580,3581,3582,3583,3584,3585,3586,3587,3588,3589,3590,3591,3592,3593,3594,3595,3596,2642,2643,2644,2645,2646,2647,2648,2648,2727,2727,2806,2806,2806,2885
3576,3577,3578,3579,3580,3581,3582,3583,3584,3585,3586,3587,3588,3589,3590,3591,3592,3593,3594,3595,3596,2641,2642,2643,2644,2645,2646,2647,2648,2648,2727,2806,2885,2964,3493,3335,3256,3098,2940,2782,2703,2624,2625,2626,2627,2628,2629,2630,2631,2632,2633,2634,2635,2636,2637,2638,2703,2861,3019,3256,3414,3572,3573,3574,3575,3257,3577,3578,3579,3580,3581,3582,3583,3584,3585,3586,3587,3588,3589,3590,3591,3592,3593,3594,3595,3596,2644,2645,2646,2647,2648,2648,2727,2727,2806,2806,2885,2885,2885,2964
3576,3577,3578,3579,3580,3581,3582,3583,3584,3585,3586,3587,3588,3589,3590,3591,3592,3593,3594,3595,3596,2642,2643,2644,2645,2646,2647,2648,2727,2727,2806,2885,2964,3043,3572,3414,3335,3177,3019,2861,2782,2624,2625,2626,2627,2628,2629,2630,2631,2632,2633,2634,2635,2636,2637,2624,2782,2940,3098,3335,3493,3572,3573,3574,3575,3336,3577,3578,3579,3580,3581,3582,3583,3584,3585,3586,3587,3588,3589,3590,3591,3592,3593,3594,3595,3596,2646,2647,2648,2648,2727,2727,2806,2806,2885,2885,2964,2964,2964,3043
3576,3577,3578,3579,3580,3581,3582,3583,3584,3585,3586,3587,3588,3589,3590,3591,3592,3593,3594,3595,3596,2644,2645,2646,2647,2648,2648,2727,2806,2806,2885,2964,3043,3122,3201,3493,3414,3256,3098,2940,2861,2703,2624,2625,2626,2627,2628,2629,2630,2631,2632,2633,2634,2635,2636,2703,2861,3019,3177,3414,3572,3573,3574,3575,3257,3577,3578,3579,3580,3581,3582,3583,3584,3585,3586,3587,3588,3589,3590,3591,3592,3593,3594,3595,3596,2648,2648,2648,2727,2727,2806,2806,2885,2885,2964,2964,3043,3043,3043,3122
3576,3577,3578,3579,3580,3581,3582,3583,3584,3585,3586,3587,3588,3589,3590,3591,3592,3593,3594,3595,3596,2646,2647,2648,2648,2727,2727,2806,2885,2885,2964,3043,3122,3201,3280,3572,3493,3335,3177,3019,2940,2782,2624,2625,2626,2627,2628,2629,2630,2631,2632,2633,2634,2635,2624,2782,2940,3098,3256,3493,3572,3573,3574,3575,3336,3577,3578,3579,3580,3581,3582,3583,3584,3585,3586,3587,3588,3589,3590,3591,3592,3593,3594,3595,3596,2727,2727,2727,2806,2806,2885,2885,2964,2964,3043,3043,3122,3122,3122,3201
3577,3578,3579,3580,3581,3582,3583,3584,3585,3586,3587,3588,3589,3590,3591,3592,3593,3594,3595,3596,2646,2647,2648,2727,2727,2806,2806,2885,2964,2964,3043,3122,3201,3280,3359,3438,3572,3414,3256,3098,3019,2861,2703,2624,2625,2626,2627,2628,2629,2630,2631,2632,2633,2634,2703,2861,3019,3177,3335,3572,3573,3574,3575,3178,3577,3578,3579,3580,3581,3582,3583,3584,3585,3586,3587,3588,3589,3590,3591,3592,3593,3594,3595,3596,2727,2806,2806,2806,2885,2885,2964,2964,3043,3043,3122,3122,3201,3201,3201,3280
3577,3578,3579,3580,3581,3582,3583,3584,3585,3586,3587,3588,3589,3590,3591,3592,3593,3594,3595,3596,2648,2648,2727,2806,2806,2885,2885,2964,3043,3043,3122,3201,3280,3359,3438,3517,3596,3493,3335,3177,3098,2940,2782,2624,2625,2626,2627,2628,2629,2630,2631,2632,2633,2634,2782,2940,3098,3256,3414,3572,3573,3574,3575,3257,3577,3578,3579,3580,3581,3582,3583,3584,3585,3586,3587,3588,3589,3590,3591,3592,3593,3594,3595,3596,2806,2885,2885,2885,2964,2964,3043,3043,3122,3122,3201,3201,3280,3280,3280,3359
3577,3578,3579,3580,3581,3582,3583,3584,3585,3586,3587,3588,3589,3590,3591,3592,3593,3594,3595,3596,2727,2727,2806,2885,2885,2964,2964,3043,3122,3122,3201,3280,3359,3438,3517,3596,3359,3572,3414,3256,3177,3019,2861,2703,2624,2625,2626,2627,2628,2629,2630,2631,2632,2624,2861,3019,3177,3335,3493,3572,3573,3574,3575,3336,3577,3578,3579,3580,3581,3582,3583,3584,3585,3586,3587,3588,3589,3590,3591,3592,3593,3594,3595,3596,2885,2964,2964,2964,3043,3043,3122,3122,3201,3201,3280,3280,3359,3359,3359,3438
3577,3578,3579,3580,3581,3582,3583,3584,3585,3586,3587,3588,3589,3590,3591,3592,3593,3594,3595,3596,2806,2806,2885,2964,2964,3043,3043,3122,3201,3201,3280,3359,3438,3517,3596,3438,3438,3438,3493,3335,3256,3098,2940,2782,2624,2625,2626,2627,2628,2629,2630,2631,2624,2703,2940,3098,3256,3414,3572,3573,3574,3575,3336,3577,3578,3579,3580,3581,3582,3583,3584,3585,3586,3587,3588,3589,3590,3591,3592,3593,3594,3595,3596,2964,2964,3043,3043,3043,3122,3122,3201,3201,3280,3280,3359,3359,3438,3438,3438,3517
3578,3579,3580,3581,3582,3583,3584,3585,3586,3587,3588,3589,3590,3591,3592,3593,3594,3595,3596,2806,2885,2885,2964,3043,3043,3122,3122,3201,3280,3280,3359,3438,3517,3596,3517,3517,3517,3517,3572,3414,3335,3177,3019,2861,2703,2624,2625,2626,2627,2628,2629,2630,2703,2782,3019,3177,3335,3493,3572,3573,3574,3575,3415,3577,3578,3579,3580,3581,3582,3583,3584,3585,3586,3587,3588,3589,3590,3591,3592,3593,3594,3595,3596,3043,3043,3122,3122,3122,3201,3201,3280,3280,3359,3359,3438,3438,3517,3517,3517,3596
3578,3579,3580,3581,3582,3583,3584,3585,3586,3587,3588,3589,3590,3591,3592,3593,3594,3595,3596,2885,2964,2964,3043,3122,3122,3201,3201,3280,3359,3359,3438,3517,3596,3596,3596,3596,3596,3596,3596,3493,3414,3256,3098,2940,2782,2624,2625,2626,2627,2628,2629,2630,2782,2861,3098,3256,3414,3572,3573,3574,3575,3415,3577,3578,3579,3580,3581,3582,3583,3584,3585,3586,3587,3588,3589,3590,3591,3592,3593,3594,3595,3596,3043,3122,3122,3201,3201,3201,3280,3280,3359,3359,3438,3438,3517,3517,3596,3596,3596,3575
3578,3579,3580,3581,3582,3583,3584,3585,3586,3587,3588,3589,3590,3591,3592,3593,3594,3595,3596,2964,3043,3043,3122,3201,3201,3280,3280,3359,3438,3438,3517,3596,3596,3055,2976,2976,2897,2897,2818,3572,3493,3335,3177,3019,2861,2703,2624,2625,2626,2627,2628,2629,2861,2940,3177,3335,3493,3572,3573,3574,3575,3415,3577,3578,3579,3580,3581,3582,3583,3584,3585,3586,3587,3588,3589,3590,3591,3592,3593,3594,3595,3596,3122,3201,3201,3280,3280,3280,3359,3359,3438,3438,3517,3517,3596,3596,3572,3573,3574,3575
3578,3579,3580,3581,3582,3583,3584,3585,3586,3587,3588,3589,3590,3591,3592,3593,3594,3595,3596,3043,3122,3122,3201,3280,3280,3359,3359,3438,3517,3517,3596,3213,3134,3134,3055,3055,2976,2976,2897,2897,3572,3414,3256,3098,2940,2782,2624,2625,2626,2627,2628,2629,2940,3019,3256,3414,3572,3573,3574,3575,3415,3577,3578,3579,3580,3581,3582,3583,3584,3585,3586,3587,3588,3589,3590,3591,3592,3593,3594,3595,3596,3201,3201,3280,3280,3359,3359,3359,3438,3438,3517,3517,3596,3596,2940,3256,3572,3573,3574,3575
3578,3579,3580,3581,3582,3583,3584,3585,3586,3587,3588,3589,3590,3591,3592,3593,3594,3595,3596,3122,3201,3201,3280,3359,3359,3438,3438,3517,3596,3596,3371,3292,3213,3213,3134,3134,3055,3055,2976,2976,2976,3493,3335,3177,3019,2861,2703,2624,2625,2626,2627,2628,3019,3098,3335,3493,3572,3573,3574,3575,3415,3577,3578,3579,3580,3581,3582,3583,3584,3585,3586,3587,3588,3589,3590,3591,3592,3593,3594,3595,3596,3280,3280,3359,3359,3438,3438,3438,3517,3517,3596,3596,2703,2861,3019,3335,3572,3573,3574,3575
3578,3579,3580,3581,3582,3583,3584,3585,3586,3587,3588,3589,3590,3591,3592,3593,3594,3595,3596,3201,3280,3280,3359,3438,3438,3517,3517,3596,3608,3450,3450,3371,3292,3292,3213,3213,3134,3134,3055,3055,3055,3572,3414,3256,3098,2940,2782,2703,2624,2625,2626,2627,3098,3177,3414,3572,3573,3574,3575,3415,3577,3578,3579,3580,3581,3582,3583,3584,3585,3586,3587,3588,3589,3590,3591,3592,3593,3594,3595,3596,3280,3359,3359,3438,3438,3517,3517,3517,3596,3596,2344,2624,2782,2940,3098,3414,3572,3573,3574,3575
3579,3580,3581,3582,3583,3584,3585,3586,3587,3588,3589,3590,3591,3592,3593,3594,3595,3596,3201,3280,3359,3359,3438,3517,3517,3596,3596,3845,3687,3529,3529,3450,3371,3371,3292,3292,3213,3213,3134,3134,3134,3055,3493,3335,3177,3019,2861,2782,2624,2625,2626,2627,3177,3256,3493,3572,3573,3574,3575,3415,3577,3578,3579,3580,3581,3582,3583,3584,3585,3586,3587,3588,3589,3590,3591,3592,3593,3594,3595,3596,3359,3438,3438,3517,3517,3596,3596,3596,2423,2423,2423,2703,2861,3019,3177,3493,3572,3573,3574,3575
3579,3580,3581,3582,3583,3584,3585,3586,3587,3588,3589,3590,3591,3592,3593,3594,3595,3596,3280,3359,3438,3438,3517,3596,3596,4318,4319,3924,3766,3608,3608,3529,3450,3450,3371,3371,3292,3292,3213,3213,3213,3134,3572,3414,3256,3098,2940,2861,2703,2624,2625,2626,3256,3335,3572,3573,3574,3575,3415,3577,3578,3579,3580,3581,3582,3583,3584,3585,3586,3587,3588,3589,3590,3591,3592,3593,3594,3595,3596,3359,3438,3517,3517,3596,3596,3450,3529,2502,2502,2502,2624,2782,2940,3098,3256,3572,3573,3574,3575,3576
3579,3580,3581,3582,3583,3584,3585,3586,3587,3588,3589,3590,3591,3592,3593,3594,3595,3596,3359,3438,3517,3517,3596,4316,4317,4318,4319,4003,3845,3687,3687,3608,3529,3529,3450,3450,3371,3371,3292,3292,3292,3213,3213,3493,3335,3177,3019,2940,2782,2624,2625,2626,3335,3414,3572,3573,3574,3575,3416,3577,3578,3579,3580,3581,3582,3583,3584,3585,3586,3587,3588,3589,3590,3591,3592,3593,3594,3595,3596,3438,3517,3596,3596,3608,3450,3529,3608,2581,2581,2624,2703,2861,3019,3177,3335,3572,3573,3574,3575,3576
3579,3580,3581,3582,3583,3584,3585,3586,3587,3588,3589,3590,3591,3592,3593,3594,3595,3596,3438,3517,3596,3596,4315,4316,4317,4318,4319,4082,3924,3766,3766,3687,3608,3608,3529,3529,3450,3450,3371,3371,3371,3292,3292,3572,3414,3256,3098,3019,2861,2703,2624,2625,3414,3493,3572,3573,3574,3575,3416,3577,3578,3579,3580,3581,3582,3583,3584,3585,3586,3587,3588,3589,3590,3591,3592,3593,3594,3595,3596,3517,3596,3608,3608,3687,3529,3608,3687,2660,2660,2703,2782,2940,3098,3256,3414,3572,3573,3574,3575,3576
3579,3580,3581,3582,3583,3584,3585,3586,3587,3588,3589,3590,3591,3592,3593,3594,3595,3596,3517,3596,4313,4314,4315,4316,4317,4318,4319,4161,4003,3845,3845,3766,3687,3687,3608,3608,3529,3529,3450,3450,3450,3371,3371,3371,3493,3335,3177,3098,2940,2782,2624,2625,3493,3572,3573,3574,3575,3416,3577,3578,3579,3580,3581,3582,3583,3584,3585,3586,3587,3588,3589,3590,3591,3592,3593,3594,3595,3596,3517,3596,3608,3687,3687,3766,3608,3687,3766,2739,2624,2782,2861,3019,3177,3335,3493,3572,3573,3574,3575,3576
3579,3580,3581,3582,3583,3584,3585,3586,3587,3588,3589,3590,3591,3592,3593,3594,3595,3596,3596,4312,4313,4314,4315,4316,4317,4318,4319,4240,4082,3924,3924,3845,3766,3766,3687,3687,3608,3608,3529,3529,3529,3450,3450,3450,3572,3414,3256,3177,3019,2861,2703,2624,3572,3573,3574,3575,3415,3577,3578,3579,3580,3581,3582,3583,3584,3585,3586,3587,3588,3589,3590,3591,3592,3593,3594,3595,3596,3596,3596,3687,3687,3766,3766,3845,3687,3766,3845,2624,2703,2861,2940,3098,3256,3414,3572,3573,3574,3575,3576,3577
3579,3580,3581,3582,3583,3584,3585,3586,3587,3588,3589,3590,3591,3592,3593,3594,3595,3596,4310,4311,4312,4313,4314,4315,4316,4317,4318,4319,4161,4003,4003,3924,3845,3845,3766,3766,3687,3687,3608,3608,3608,3529,3529,3529,3529,3493,3335,3256,3098,2940,2782,2624,3572,3573,3574,3575,3416,3577,3578,3579,3580,3581,3582,3583,3584,3585,3586,3587,3588,3589,3590,3591,3592,3593,3594,3595,3596,3608,3687,3766,3766,3845,3845,3924,3766,3845,2624,2703,2782,2940,3019,3177,3335,3493,3572,3573,3574,3575,3576,3577
3579,3580,3581,3582,3583,3584,3585,3586,3587,3588,3589,3590,3591,3592,3593,3594,3595,3596,4310,4311,4312,4313,4314,4315,4316,4317,4318,4319,4240,4082,4082,4003,3924,3924,3845,3845,3766,3766,3687,3687,3687,3608,3608,3608,3608,3572,3414,3335,3177,3019,2861,2703,2624,2625,2626,2627,2628,2629,2630,2631,2632,2633,2634,2635,2636,2637,2638,2639,2640,2641,2642,2643,2644,2645,2646,2647,2648,3687,3766,3845,3845,3924,3924,4003,3845,3924,2703,2782,2861,3019,3098,3256,3414,3572,3573,3574,3575,3576,3577,3578
3579,3580,3581,3582,3583,3584,3585,3586,3587,3588,3589,3590,3591,3592,3593,3594,3595,3596,4309,4310,4311,4312,4313,4314,4315,4316,4317,4318,4319,4161,4161,4082,4003,4003,3924,3924,3845,3845,3766,3766,3766,3687,3687,3687,3687,3687,3493,3414,3256,3098,2940,2782,2624,2625,2626,2627,2628,2629,2630,2631,2632,2633,2634,2635,2636,2637,2638,2639,2640,2641,2642,2643,2644,2645,2646,2647,2648,3766,3845,3924,3924,4003,4003,4082,3924,2624,2782,2861,2940,3098,3177,3335,3493,3572,3573,3574,3575,3576,3577,3578
3579,3580,3581,3582,3583,3584,3585,3586,3587,3588,3589,3590,3591,3592,3593,3594,3595,3596,4309,4310,4311,4312,4313,4314,4315,4316,4317,4318,4319,4240,4240,4161,4082,4082,4003,4003,3924,3924,3845,3845,3845,3766,3766,3766,3766,3766,3572,3493,3335,3177,3019,2861,2703,2624,2625,2626,2627,2628,2629,2630,2631,2632,2633,2634,2635,2636,2637,2638,2639,2640,2641,2642,2643,2644,2645,2646,2647,2648,3924,4003,4003,4082,4082,4161,2624,2703,2861,2940,3019,3177,3256,3414,3572,3573,3574,3575,3576,3577,3578,3579
3580,3581,3582,3583,3584,3585,3586,3587,3588,3589,3590,3591,3592,3593,3594,3595,3596,3201,4308,4309,4310,4311,4312,4313,4314,4315,4316,4317,4318,4319,4319,4240,4161,4161,4082,4082,4003,4003,3924,3924,3924,3845,3845,3845,3845,3845,3766,3572,3414,3256,3098,2940,2782,2703,2624,2625,2626,2627,2628,2629,2630,2631,2632,2633,2634,2635,2636,2637,2638,2639,2640,2641,2642,2643,2644,2645,2646,2647,2648,4082,4082,4161,4161,2624,2703,2782,2940,3019,3098,3256,3335,3493,3572,3573,3574,3575,3576,3577,3578,3579
3580,3581,3582,3583,3584,3585,3586,3587,3588,3589,3590,3591,3592,3593,3594,3595,3596,3280,4306,4307,4308,4309,4310,4311,4312,4313,4314,4315,4316,4317,4318,4319,4240,4240,4161,4161,4082,4082,4003,4003,4003,3924,3924,3924,3924,3924,3845,3845,3493,3335,3177,3019,2861,2782,2624,2625,2626,2627,2628,2629,2630,2631,2632,2633,2634,2635,2636,2637,2638,2639,2640,2641,2642,2643,2644,2645,2646,2647,2648,4161,4161,4240,2624,2703,2782,2861,3019,3098,3177,3335,3414,3572,3573,3574,3575,3576,3577,3578,3579,3580
3580,3581,3582,3583,3584,3585,3586,3587,3588,3589,3590,3591,3592,3593,3594,3595,3596,3359,4305,4306,4307,4308,4309,4310,4311,4312,4313,4314,4315,4316,4317,4318,4319,4319,4240,4240,4161,4161,4082,4082,4082,4003,4003,4003,4003,4003,3924,3924,3572,3414,3256,3098,2940,2861,2703,2624,2625,2626,2627,2628,2629,2630,2631,2632,2633,2634,2635,2636,2637,2638,2639,2640,2641,2642,2643,2644,2645,2646,2647,2648,4240,4319,2703,2782,2861,2940,3098,3177,3256,3414,3493,3572,3573,3574,3575,3576,3577,3578,3579,3580
